11111111111111111111111111111111
1..............................1
1............000000............1
1..............................1
1.........00000..00000.........1
1..............................1
1......000000000000000000......1
1..............................1
1..00000...0000000000...00000..1
1..............................1
11111111111111111111111111111111
................................
................................