11111111111111111111111111111111
1..............................1
10000.........0000.........00001
1..............................1
10000.......00000000.......00001
1..............................1
10000.....000000000000.....00001
1..............................1
10000....00000000000000....00001
1..............................1
11111111111111111111111111111111