111111111....111111....111111111
1..............................1
1........000........000........1
1.......0...00...000...0.......1
1.......0.....00.0.....0.......1
1........00....0.....00........1
1..........00......00..........1
1............00..00............1
1..............0...............1
1..............................1
111111111....111111....111111111
................................
................................